NO ./textures/north.png
SO ./textures/north.png
WE ./textures/north.png
EA ./textures/north.png

F 220,100,0
C 225,30,0

11111111111111111111
10000000000000000001
10000000W00000000001
10000000000000000001
10000011101110000001
10000010000010000001
10000011111110000001
10000000000000000001
10000000000000000001
10000000000000000001
10000000000000000001
11111111111111111111