NO ./textures/north.png
SO ./textures/north.png
WE ./textures/north.png
EA ./textures/north.png

F 220,100,0
C 225,30,0

11111111111111111
10000000000000001
100N0000000000001
10000000000000001
10000000000000001
10000000100000001
10000000100000001
10000000000000001
10000000000000001
10000000000000001
11111111111111111