NO ./textures/dark_wall.png
SO ./textures/dark_wall.png
WE ./textures/dark_wall.png
EA  ./textures/dark_wall.png

F 40,40,40
C 10,10,25

111111111111111111111111111111111111111111111111111
101000000000100000000010000000000000100000001000101
101011111010101111111010011011111110101110101010101
101000101000001010000010000010000010001000100010101
101100101011101010111110101010101110111010111110101
101000001000100010001000001010100000100000000000001
101011101110101011100011111010111011101101001011101
101000001000100010101010000010100010000000101000001                           
101100101000101010101110111111101110111010100110111
100010100010001000100010000000100000100010100010001
111011101110101111110010110110101111010011111011101
101000101000000000001010000010000000000010001010001
101110101011101010101000001110111101001110101010111
100010000000000010101000100010000000101000000010101
101011111110110110110100101010110000101010111000101
101000000010100010000010001010000010001010100010101
101110001000111011011011101010111110111010100110101
100000001010001000001000101000100000001010101010001
111010111110101011001010001001111111100010101010101
100010100000100000001010000010000000000010000010001
101111101110101101101011101000111111001011111111101
100010000000000000001000100000100000101000000000001
101010111100001011001010101110101110101011111111011
101010001000101000100000100000101000000000001000001
111010101010101010101010111110101010111101101011101
100010001000101010000010000010100010000000101010001
101111101011101010111111111010101001111010001010111
101000101000100010100010000000000000001010100010101
101010101110111110101010101111100110001011111110101
1000100000100000000010100000000000001010000000000W1
111111111111111111111111111111111111111111111111111
