NO ./textures/rais_hand.png 
SO ./textures/flag.png 
WE ./textures/raising_flag.png
EA  ./textures/abo_oubaida.png


F 68,58,41
C 25,45,70


111111111111111111111111111111111111111111111111111
100000000000001110000000000000000001000000000000001
100000000011111111100001111111111111011111100000001
100000000010000000100001000000000001000000100000001
100111111010111011101111011101110111011101111100001
100100001010100000100000010100000101010000100000001
100101101010101110111110010101110101011110111000001
100100100010100010000010000100010101000010001000001
100111100010101011101111110101011101011110101110001
100000100000101000100000000101000100000000100000001
111110111111101011101011111101011101011111101011101
100010100000001010001010000001000100000000100010001
100010101111101011101011101111101011111011101010001
100010100000101010001000100000101000100000000010001
100111101110101011101011101011101011101011111010001
100000100010101000100010001000100000100000100010001
101111101010101011101010111011101110111010111011101
100000001010001000100010100000100000001010000000001
100111111011101011101110111011101011101011111011101
100100000010001010000000100000101000100000000100001
100101110111101011111011101111101011101111101110001
100100000000001000001000000000100000100000000100001
111111101111111111111111111111111111111011111111101
100000000000000000000000000000000000000000000000001
100111111111111011101111110111011101111011111110001
100100000000001010001000000101000100000100000100001
100101111011101011101011101101011101011101011101001
100100001010001000000100000101000100000100000100001
100111101011101011111011101111101011111011111010001
1000000000100000000000000000000000000000000000000W1
111111111111111111111111111111111111111111111111111
