NO ./textures/no.png
SO ./textures/ea.jpng
WE ./textures/so.png
EA  ./textures/we.png

F 147,156,255
C 42,178,209

11111111111111111
10010010010010001
1000000E000000001
10010010101000001
11101100101001101
10010010010010001
10000000000000001
10010010010010001
10001101100100111
10001001101100001
11111111111111111