NO ./textures/north.png
SO ./textures/north.png
WE ./textures/north.png
EA ./textures/north.png

F 220,100,0
C 225,30,0

11111111111111111
10010010010010001
1000000W000000001
10010010010010001
11101100101001101
10010010010010001
10000000000000001
10010010010010001
10001101100100111
10001001101100001
11111111111111111