NO ./textures/no.png
SO ./textures/ea.png
WE ./textures/so.png
EA ./textures/we.png

F 250,200,50
C 245,245,245

11111111111111111
100100100100100001
1000000E000000001
100100100100100001
11101100101001101
10010010010010001
10000000000000001
10010010010010001
10001101100100111
10001001101100001
11111111111111111