NO ./textures/no.png
SO ./textures/ea.png
WE ./textures/so.png
EA ./textures/we.png

F 100,100,100
C 245,245,245

1111
10001
10W01
1001
1001
1001
1111