NO ./textures/no.png
SO ./textures/ea.png
WE ./textures/so.png
EA ./textures/we.png

F 100,100,100
C 245,245,245

11111111
10000001
10W00001
10000001
10000001
10000001
11111111