NO ./textures/no.png
SO ./textures/ea.png
WE ./textures/so.png


F 147,156,158
C 42,178,209

11111111
10000001
10E00001
10000001
10000001
10000001
11111111