NO ./textures/no.png
SO ./textures/so.png
WE ./textures/we.png
EA  ./textures/ea.png

F 147,156,255
C 42,178,209

11111111         
11111111
10000001
10E0001
10000001
11111111
11111111
10000001
10000001
11111111