NO ./textures/no.png
SO ./textures/ea.png
WE ./textures/so.png
EA ./textures/we.png

F 147,156,255
C 42,178,209

11111111
10000001
10W0001
10000001
11111111
11111111
10000001
10000001
11111111